DataFrame.rename() method to rename a columns name of a DataFrame.
DataFrame.insert() method to insert a new column at a specified location
DataFrame.replace() method to replace specific values within a column of a DataFrame.
DataFrame.drop() method to delete single or multiple columns of a DataFrame 




Format	         Reader                 Function	Writer Function
Tabular          Data	                read_table()	NA
CSV	         read_csv()	        to_csv()
Fixed-Width      Text File	        read_fwf()	NA
Clipboard	 read_clipboard()	to_clipboard()
Pickling	 read_pickle()	        to_pickle()
Excel	         read_excel()	        to_excel()
JSON	         read_json()	        to_json()
HTML	         read_html()	        to_html()
XML	         read_xml()	        to_xml()
LaTeX	NA	 to_latex()
HDF5 Format	 read_hdf()	        to_hdf()
Feather	         read_feather()	        to_feather()
Parquet	         read_parquet()	        to_parquet()
ORC	         read_orc()	        to_orc()
SQL	         read_sql()	        to_sql()
Stata	         read_stata()	        to_stata()